Key	zh-CN	en-US
SettingsPage_Title	设置	Settings
SettingsPage_Saved_Toast_Title	设置已保存	Settings Saved
SettingsGroup_Common_Header	基础	Common
Settings_Common_Language_Header	语言	Language
Settings_Common_Language_Description	选择软件界面语言。	Select the display language for the software.
SettingsSelectionItem_Common_Language_zh-CN	中文（简体）	中文（简体）
SettingsSelectionItem_Common_Language_en-US	English (United States)	English (United States)
Settings_Common_Theme_Header	主题	Theme
Settings_Common_Theme_Description	选择软件界面主题。	Select the display theme for the software.
SettingsSelectionItem_Common_Theme_System	跟随系统	Follow System
SettingsSelectionItem_Common_Theme_Dark	深色主题	Dark Theme
SettingsSelectionItem_Common_Theme_Light	浅色主题	Light Theme
SettingsGroup_Behavior_Header	行为	Behavior
Settings_Behavior_AssistantHotkey_Header	助手快捷键	Assistant Hotkey
Settings_Behavior_AssistantHotkey_Description	设置一个快捷键，在任何时候按下即可唤出助手。	Set a hotkey to invoke the assistant at any time.
Settings_Behavior_ShowAssistantFloatingWindowWhenInput_Description	开启后，在任意软件中输入时，会在旁边弹出悬浮面板以便快速访问。	When enabled, a floating panel will pop up beside the input area in any software for quick access while typing.
SettingsGroup_Model_Header	模型	Model
Settings_Model_ModelName_Header	模型名称	Model Name
Settings_Model_ModelName_Description	指定助手调用的模型名称。	Specify the name of the model the assistant will use.
Settings_Model_Endpoint_Header	模型API接口地址	Model API Endpoint
Settings_Model_Endpoint_Description	指定助手使用的 API 端点 URL，仅填写根路径，不要包含具体接口路径（例如：https://openai.com/api/v1）	Specify the base API endpoint URL for the assistant; supply only the root path without including specific endpoint routes (e.g., https://openai.com/api/v1).
Settings_Model_ApiKey_Header	模型 API Key	Model API Key
Settings_Model_ApiKey_Description	指定用于访问模型 API 的密钥，可在模型提供方的 API 网站获取；对于无需验证的本地模型（如 Ollama 或 LM Studio），请留空。	Specify the API access key for the model, obtainable from the provider’s API site; leave blank for local models (e.g., Ollama or LM Studio) that do not require authentication.
Settings_Model_Temperature_Header	创意活跃度（Temperature）	Creativity (Temperature)
Settings_Model_Temperature_Description	数值越高，回答越具创造力和想象力；数值越低，则越趋严谨；部分模型数值超过 1.0 可能导致输出乱码。	Higher values yield more imaginative, creative responses; lower values produce more precise, conservative outputs; note that temperatures above 1.0 may cause garbled output in some models.
Settings_Model_TopP_Header	思维开放度（Top p）	Thought Openness (Top p)
Settings_Model_TopP_Description	数值越高，模型会接受更多潜在回答；数值越低，则更倾向于最可能的回答；不建议与创意活跃度同时调整。	Higher values allow a wider range of possible responses; lower values favor the most probable answers; it’s not recommended to modify this alongside the temperature.
Settings_Model_IsImageSupported_Header	开启图像多模态	Enable Multimodal Image Support
Settings_Model_IsImageSupported_Description	启用此功能后，在支持图像输入的大模型（如 GPT-4o）调用时，助手会在适当时机传递视觉信息以增强上下文理解；若模型不支持图像上传，开启后可能导致调用失败。	When enabled, for vision-capable models (e.g., GPT-4o), the assistant will include images at the right times to enhance contextual understanding; if the model doesn’t support image inputs, enabling this may cause failures.
Settings_Model_IsToolCallSupported_Header	开启工具调用	Enable Tool Calling
Settings_Model_IsToolCallSupported_Description	启用后，在支持工具调用的大模型（如 DeepSeek-V3、GPT-4o）中，助手会在合适时机调用外部工具以扩展能力；若模型不支持此功能，则可能导致调用失败。	When enabled, for tool-capable large models (e.g., DeepSeek-V3, GPT-4o), the assistant will invoke external tools at appropriate times to extend its capabilities; if the model doesn’t support tool calls, enabling this may cause failures.
Settings_Model_IsWebSearchSupported_Header	开启网络搜索	Enable Web Search
Settings_Model_IsWebSearchSupported_Description	启用后，在支持工具调用的大模型（如 DeepSeek-V3、GPT-4o）中，助手会先进行网络搜索并整合结果后再生成回复；若模型不支持此功能，则可能导致调用失败。	When enabled, for tool-capable large models (e.g., DeepSeek-V3, GPT-4o), the assistant will perform web searches and integrate results before generating responses; if the model doesn’t support tool calls, enabling this may cause failures.
Settings_Model_WebSearchProvider_Header	网络搜索服务提供方	Web Search Service Provider
Settings_Model_WebSearchProvider_Description	选择用于网络搜索的服务提供商。	Select the service provider for web searches.
SettingsSelectionItem_Model_WebSearchProvider_bing	必应	Bing
SettingsSelectionItem_Model_WebSearchProvider_google	谷歌	Google
SettingsSelectionItem_Model_WebSearchProvider_brave	brave	brave
SettingsSelectionItem_Model_WebSearchProvider_bocha	博查	Bocha
Settings_Model_WebSearchApiKey_Header	网络搜索服务 API Key	Web Search Service API Key
Settings_Model_WebSearchApiKey_Description	指定网络搜索服务的 API 访问密钥，可在对应服务提供商的 API 控制台获取。	Specify the API access key for the web search service, obtainable from the provider’s API portal.
Settings_Model_WebSearchEndpoint_Header	网络搜索服务API接口地址	Web Search Service API Endpoint
Settings_Model_WebSearchEndpoint_Description	（可选）如使用官方 API 接口，请留空以使用默认值。	(Optional) Leave blank to use the default value when using the official API endpoint.
ChatInputBox_Watermark	询问 Everywhere 助手	Ask Everywhere
ChatInputBox_AddAttachmentButton_ToolTip	添加附件到对话	Add attachments to the conversation
ChatInputBox_AddAttachmentMenuItem_Header	添加附件	Add Attachment
ChatInputBox_ImageButton_ToolTip	允许访问屏幕上的图像	Allow access to aware your screen
ChatInputBox_ImageButton_Text	图像	Image
ChatInputBox_WebSearchButton_ToolTip	在网络上搜索	Search the web
ChatInputBox_WebSearchButton_Text	搜索	Search
ChatInputBox_ToolCallButton_ToolTip	使用工具强化助手能力	Use tools to enhance assistant capabilities
ChatInputBox_ToolCallButton_Text	工具	Tools
ChatInputBox_SendButton_ToolTip	发送	Send
ChatInputBox_CancelButton_ToolTip	取消	Cancel
AssistantCommand_Translate_Description	翻译为目标语言	Translate into the target language
AssistantCommand_Rewrite_Description	按要求重写	Rewrite as required
ActionChatMessage_Header_AnalyzingContext	分析上下文	Analyze context
ActionChatMessage_Header_WebSearching	搜索网络	Web Search
ChatFloatingWindow_ChatMessage_Assistant_Regenerate	重新回答	Regenerate
ChatFloatingWindow_ChatMessage_Assistant_Copy	复制回答	Copy
Application_TrayIcon_Menu_OpenMainWindow	打开主窗口	Open Window
Application_TrayIcon_Menu_Exit	退出	Exit
Application_TrayIcon_Menu_OpenDebugWindow	打开调试窗口	Open Debug Window
ChatFloatingWindow_History_ToolTip	对话历史	Conversation History
ChatFloatingWindow_CreateNew_ToolTip	创建新会话	Create New Session
ChatFloatingWindow_Close_ToolTip	关闭	Close
ChatFloatingWindow_ChatInputBox_AddAttachmentMenuItems_AddScreen	添加屏幕	Add Screen
ChatFloatingWindow_ChatInputBox_AddAttachmentMenuItems_AddWindow	添加窗口	Add Window
ChatFloatingWindow_ChatInputBox_AddAttachmentMenuItems_AddElement	添加元素	Add Element
ChatFloatingWindow_ChatInputBox_AddAttachmentMenuItems_AddClipboard	添加剪切板	Add Clipboard
ChatFloatingWindow_ChatInputBox_AddAttachmentMenuItems_AddFile	添加文件	Add File
ChatFloatingWindowViewModel_TextEditActions_Translate	翻译	Translate
ChatFloatingWindowViewModel_TextEditActions_ContinueWriting	续写	Continue
ChatFloatingWindowViewModel_TextEditActions_Summarize	总结	Summary
ChatFloatingWindow_Title	有什么可以帮忙的？	How can I assist you?
KeyboardHotkeyInputBox_Watermark	点击设置快捷键	Click to set a hotkey
ChatContext_Metadata_Title_Default	未命名会话	Unnamed session
ChatAttachment_RemoveButton_ToolTip	移除	Remove
VisualElementType_Unknown	未知	Unknown
VisualElementType_Label	标签	Label
VisualElementType_TextEdit	文本框	Text box
VisualElementType_Document	文档	Document
VisualElementType_Button	按钮	Button
VisualElementType_Hyperlink	超链接	Hyperlink
VisualElementType_Image	图片	Image
VisualElementType_CheckBox	复选框	Check box
VisualElementType_RadioButton	单选按钮	Radio button
VisualElementType_ComboBox	组合框	Combo box
VisualElementType_ListView	列表视图	List
VisualElementType_ListViewItem	列表项	List item
VisualElementType_TreeView	树视图	Tree
VisualElementType_TreeViewItem	树项	Tree item
VisualElementType_DataGrid	数据表	Table
VisualElementType_DataGridItem	数据项	Table item
VisualElementType_TabControl	标签页	Tab
VisualElementType_TabItem	标签页	Tab
VisualElementType_Table	表格	Table
VisualElementType_TableRow	表格	Table
VisualElementType_Menu	菜单	Menu
VisualElementType_MenuItem	菜单项	MenuItem
VisualElementType_Slider	滑块	Slider
VisualElementType_ScrollBar	滚动条	ScrollBar
VisualElementType_ProgressBar	进度条	ProgressBar
VisualElementType_Panel	面板	Panel
VisualElementType_TopLevel	窗口	Window
VisualElementType_Screen	屏幕	Screen
HumanizedDate_Today	今天	Today
HumanizedDate_Yesterday	昨天	Yesterday
HumanizedDate_LastWeek	一周内	Last week
HumanizedDate_LastMonth	一月内	Last month
HumanizedDate_LastYear	一年内	Last year
HumanizedDate_Earlier	更早	Earlier
FriendlyExceptionMessage_HttpRequest	HTTP请求错误（{0}）：{1}
FriendlyExceptionMessage_HttpRequest_BadRequest	错误的请求
FriendlyExceptionMessage_HttpRequest_Unauthorized	请求未授权
FriendlyExceptionMessage_HttpRequest_Forbidden	请求被阻止
FriendlyExceptionMessage_HttpRequest_NotFound	未找到结果
FriendlyExceptionMessage_HttpRequest_InternalServerError	服务器遇到错误，请稍后再试
FriendlyExceptionMessage_HttpRequest_ServiceUnavailable	服务器遇到错误，请稍后再试
FriendlyExceptionMessage_HttpRequest_GatewayTimeout	网关连接超时，请检查网络或稍后再试
FriendlyExceptionMessage_HttpRequest_RequestTimeout	请求连接超时，请检查网络或稍后再试
FriendlyExceptionMessage_HttpRequest_BadGateway	网关连接错误，请检查网络或稍后再试
FriendlyExceptionMessage_HttpRequest_0	未知错误，请稍后再试
FriendlyExceptionMessage_Socket	套接字错误（{0}）：{1}
FriendlyExceptionMessage_Socket_HostNotFound	无法解析域名，请检查DNS设置或稍后再试
FriendlyExceptionMessage_Socket_ConnectionRefused	连接被拒绝，请检查网络或稍后再试
FriendlyExceptionMessage_Socket_ConnectionReset	连接被重置，请检查网络或稍后再试
FriendlyExceptionMessage_Socket_ConnectionAborted	连接被中止，请检查网络或稍后再试
FriendlyExceptionMessage_Socket_0	未知错误，请稍后再试
FriendlyExceptionMessage_Aggregate	"发生一个或多个错误
{0}"
FriendlyExceptionMessage_TaskCanceled	任务已取消
FriendlyExceptionMessage_OperationCanceled	操作已取消
FriendlyExceptionMessage_TimeoutException	已超过最长等待时间
FriendlyExceptionMessage_Json	无法解析JSON数据
FriendlyExceptionMessage_Format	格式错误
FriendlyExceptionMessage_Argument	参数错误